{
    "tileSet": {
        "0": {"icon": "🌳", "gather": [], "loot": []},
        "1": {"icon": "🌱", "gather": [], "loot": []},
        "2": {"icon": "🌊", "gather": [], "loot": []},
        "3": {"icon": "⛰️", "gather": [], "loot": []},
        "4": {"icon": "🏔️", "gather": [], "loot": []},
        "5": {"icon": "🏜️", "gather": [], "loot": []}
    },

    "map": [
            "0","0","0","0","0","0","0","0","0","0",
            "0","0","0","0","0","0","0","0","0","0",
            "0","0","1","1","1","1","1","1","1","0",
            "1","1","1","1","1","1","1","1","1","0",
            "1","1","1","2","2","1","1","1","1","1",
            "1","1","2","2","2","2","2","1","1","1",
            "1","1","1","2","2","2","1","1","1","1",
            "1","1","1","1","1","1","1","1","1","1",
            "1","1","1","3","3","1","1","3","4","4",
            "3","3","3","3","3","3","4","4","4","4",
            
            "3","3","4","4","4","4","4","4","4","4",
            "3","3","3","3","3","3","4","4","4","4",
            "3","3","3","3","3","3","3","3","3","3",
            "3","3","5","5","5","5","5","3","3","3",
            "5","5","5","5","5","5","5","5","5","5",
            "5","5","5","5","5","5","5","5","5","5",
            "5","5","5","5","5","5","5","5","5","5",
            "5","5","5","5","5","5","5","5","5","5",
            "5","5","5","5","5","5","5","5","5","5",
            "5","5","5","5","5","5","5","5","5","5"
            ]
}